9x9;
3x3;
1x1;
2x9;
12 5 1 7 10 7 10 5 7;
10 7 11 6 6 6 4 14 6;
6 9 7 4 8 9 8 10 2;
9 7 6 9 7 10 5 3 8;
13 6 9 1 8 9 5 5 7;
4 8 10 8 10 1 5 5 8;
6 13 4 14 6 9 5 5 7;
11 4 3 5 3 14 12 5 8;
16 11 16 16 16 16 16 16 16;
