9x8;
2x1;
3x2;
1x1;
12 7 10 1 1 1 5 1 14;
16 4 0 0 0 0 1 2 13;
16 4 0 0 0 2 4 0 2;
16 4 3 0 2 4 3 0 2;
16 4 1 2 4 0 1 0 2;
16 11 6 4 0 0 2 9 2;
16 12 2 4 2 9 0 1 2;
16 12 3 3 3 14 9 3 8;