9x9;
1x2;
9x2;
4x1;
16 16 16 13 16 16 16 16 16;
12 5 1 0 1 5 1 1 7;
10 1 0 0 0 1 0 0 2;
4 0 0 3 0 0 0 0 2;
6 9 2 13 4 0 0 2 6;
6 10 0 0 0 0 0 8 6;
6 4 0 0 0 0 0 7 6;
4 0 0 3 0 0 0 2 6;
9 3 3 5 3 3 3 3 8;